||||,8,|||||||||||
||,,,,,,,,,,,,,|||
||,,,7,,,,,,6,,,||
~~~~~~~~|||,,,,,||
~~~~~~~~|||,,,,,||
~~~~2,,3,,,,,,,,||
,,,,,,|4,,,,5,,,||
@,,,,,|,,@@,,,||||
@@@,1,@@@@@|||||||
